13 64
0006666666000
0066200016600
0660<<<<<<660
0609<<<909<60
66<<<00<66666
6000<<<<<<<66
66900<<<00906
66000<<666666
6<<<<<<<<0066
666<<<<<00966
66<00000<0<66
60<<900006666
660<<<<009066
6660090<<6666
60<<<<<<<<066
6666660000666
6000900000096
6<<<<<<<00<66
666<<0000<<<6
6666660000666
6000900000096
6<<<<<<<00<66
666<<0000<<<6
60<<<<<<<<066
6666660000666
6000900000096
6<<<<66<00<66
666<<0000<<<6
666<<<<<<<<<6
66000<<666666
6<<<<<<<<0066
666<<<<<00966
66<00000<0<66
60<<900006666
60000<<<<<<66
666<<<<<<<<<6
66000<<666666
6<<<<<<<<0066
666<<<<<00966
66<00000<0<66
60<<900006666
660<<<<009066
6660090<<6666
60<<<<<<<<066
6666660000666
6000900000096
6<<<<<<<09<66
666<<000<<<<6
66666660<<666
6090906000096
6<<<<<<<00<66
666<<0090<<<6
60<<<<<<<<066
666666000<666
60009000<0096
6<<<<66<00<66
666<<0000<<<6
666<<<<<<<<<6
66000<<66<666
6<<090<<<0066
666<<<<<<0966
66<00000<0<66
60<<9000>6666
6666666666666